W,W,W,W,W,W,W,W,W
W,G,G,G,G,G,G,G,W
W,G,G,G,G,G,G,G,W
W,G,G,C,G,G,G,G,W
W,G,G,G,G,G,G,G,W
W,G,G,G,G,G,G,G,W
W,G,G,G,G,G,G,G,W
W,G,G,G,G,G,G,G,W
W,G,G,G,G,G,G,G,W
W,W,W,N,W,W,W,W,W

W,W,W,B,W,W,W,W,W
W,G,G,G,G,G,G,G,W
W,G,G,G,G,G,G,G,W
W,G,G,G,G,G,G,G,W
W,G,G,G,L,G,G,G,W
W,G,G,G,G,G,G,G,W
W,G,R,R,R,G,G,G,W
W,G,G,G,G,G,G,G,W
W,G,G,G,G,G,G,G,W
W,W,W,W,W,W,W,W,W

